###Map Created with PsychoStrain Map Editor RC3
#
#
XXXXXXXXXXXXXXXXXXXXXXXXXXXXXXXXXXXXXXXXXXXXXXXXXXXXXXXXXXXXXXXXXXXXXXXXXXXXXXXXXXXXXXXXXXXXXXXXXXXXXXXXXXXXXXXXXXXXXXXXXXXXXXXXXXXXXXXXXXXXXXXXXXXXXXXXXXXXXXXXXXXXXXXXXXXXXXXXXXXXXXXXXXXXXXXXXXXXXXXXXXXXXXXXXXXXXXXXXXXXXXXXXXXXXXXXXXXXXXXXXXXXXXXXXXXXXXXXXXXXXXXXXXXXXXXXXXXXXXXXXXXXXXXXXXXXXXXXXXXXXXXXXXXXXXXXXXXXXXXXXXXXXXXXXXXXXXXX
828282828282828282828282828282828282828282828282828282828282828282828282828282828282828282828282828282828282828282828282828282828282828282828282828282828282828282828282828282828282828282828282828282828282828282828282828282828282828282828282828282828282828282828282828282828282828282828282828282828282828282828181818181818181000000000082
000000000000000000000000000800000869700000000800000000000000000000000000000081000000000000000800000000820000000000000000000000000000000000008200000000000000000000000000000000000078000000000000000000000008000000000000004100000041000000000000000000000000000000818181818181818181818181818181818181818181818181818181818181818181000000000000
000000000000000000000000000800000871720000000800000000000000000000000000000081000000000000000800000000820000000000000000000000000000000000008200000000000000000000000000000000000078000000000000000000000008000000000000004100000041000000000000000000000000000000818181818181818181818181818181818181818181818181818181818181818181000000000000
000000000000000000000000000800000869700000000800000000000000000000000000000081000000000000000800000000820000000000000000000000000000000000008200000000000000000000000000000000000078000000000000000000000008000000000000004100000041000000000000000005000000000000818181818181818181818181818181818181818181818181818181818181818181000000000000
000000000000000000000000000800000871720000000800000000000000000000008100000081000000000000000800000000820000000000000000000000000000000000008200000000000000000000000000000000000078000000000000000000000008000000000000004100000041000000000000004141410000000000818181818181818181818181818181818181818181818181818181818181818181000000000000
000000000000000000000000000800000869700000000800000000000000000000000000000081000000000000000800000000823030303030300000000000000000000000008200000000000000000000000000000000000078000000000000000000000008000000000000004100000041000000000000000000000000000000818181818181818181818181818181818181818181818181818181818181818181000000000000
000000000000000000000000000800000871720000000800000000000000000000000000000081000000000000000800000000171717171725300000000000000000000000008200000000000000000000000000000000000008000000000000000000000008000000000000004100000041000000004100000000000000000000818181818181818181818181818181818181818181818181818181818181818181000000000000
000000000000000000000000000800000869700000000800000000000000008181000000000081000000000000000800000082823030303021300000000000000000000000008200000000000000000000000000000000007878000000000000000000000008000000000000004100000041000000004100000000000000000000818181818181818181818181818181818181818181818181818181818181818181000000000000
000000000000000000000000000800000871720000000800000000000000000000000000000081000000000000000800000000820000003021300000000000000000000000008200000000000000000000000000000000000078000000000000000000000008000000000000004100000041000041414100000000000000000000818181818181818181818181818181818181818181818181818181818181818181000000000000
000000000000000000000000000800000869700000000800000000000000000000000000008181000000000000000800828282820000003021300000000000003030303030308200000000000000000000000000000000000078000000000000000000000014000000000000004141414141000000000000000000000000000000818181818181818181818181818181818181818181818181818181818181818181000000000000
000000000000000000000000000800000871720000000800000000000000000000000000000000000000000000000800000000820000003021300000000000003024171717171700000000000000000000007878787800000078000200000000000000008282828282820000001717172541000000000000000000000000000000818181818181818181818181818181818181818181818181818181818181818181000000000000
000000000000000000000000000800000869700000000800000000818181810000000000000000000000000000000800000000820000003021300000000000003021303030308200000000000000000000000000000000000078007878000000000000000008000000000000414141412141414100000000000000000000008282818181818181818181818181818181818181818181818181818181818181818181000000000000
000000000000000000000000000800000871720000000800000000000000000000000081810000000000000000000882828282008200003021303030303030303021300000008200000000000000000000000000000000000078000000000000000000000008000000000000414141412141000000000000000000000000002808191919191919191919191919191919193119191919191919191919191919191919000000000000
000000000000000000000000000800000879790000000800000000000000000000000000000000008181000000000800000000008282003027171717171717171726300000008200000000000000000000000000000000000078000000000000000000000008000000000000414141410800000000000000000000000000002808000000000000000000000000000000002900000000000000000000000000000000000000000000
000000000000000000000000000800000800000000000800000000000000000000000000000000000000000000000800000000000082003030303030303030303030300000008200000000000000000000000000000000000078000000000000000000000008000000000000414141410000000000000000000000000000002808202020202020202020202020202020203220202020202020202020202020202020000000000000
494949494949494949494949494949494949494949494949494949090909090909090909090909090909090909494949494949494949000000000000000000000000000000004949494949494949494949490909090909090909090909094949494949494949494949494949494949494949494949494949494949494949494949494949494949494949494949494949494949494949494949494949494949494949000000000000
#
#
>53953000
>03902500
